MavLink	KEYWORD1
hardware_serial	KEYWORD2
aircraft_type	KEYWORD2
sys_id	KEYWORD2
mission	KEYWORD2
fence	KEYWORD2
rally	KEYWORD2
Begin	KEYWORD2
Update	KEYWORD2
gnss_serial	KEYWORD2
throttle_enabled	KEYWORD2
aircraft_mode	KEYWORD2
aircraft_state	KEYWORD2
raw_sens_stream_period_ms	KEYWORD2
ext_status_stream_period_ms	KEYWORD2
rc_chan_stream_period_ms	KEYWORD2
pos_stream_period_ms	KEYWORD2
extra1_stream_period_ms	KEYWORD2
extra2_stream_period_ms	KEYWORD2
extra3_stream_period_ms	KEYWORD2
sys_time_us	KEYWORD2
cpu_load	KEYWORD2
gyro_installed	KEYWORD2
accel_installed	KEYWORD2
mag_installed	KEYWORD2
static_pres_installed	KEYWORD2
diff_pres_installed	KEYWORD2
gnss_installed	KEYWORD2
inceptor_installed	KEYWORD2
gyro_healthy	KEYWORD2
accel_healthy	KEYWORD2
mag_healthy	KEYWORD2
static_pres_healthy	KEYWORD2
diff_pres_healthy	KEYWORD2
gnss_healthy	KEYWORD2
inceptor_healthy	KEYWORD2
battery_volt	KEYWORD2
battery_current_ma	KEYWORD2
battery_consumed_mah	KEYWORD2
battery_remaining_prcnt	KEYWORD2
battery_remaining_time_s	KEYWORD2
imu_accel_x_mps2	KEYWORD2
imu_accel_y_mps2	KEYWORD2
imu_accel_z_mps2	KEYWORD2
imu_gyro_x_radps	KEYWORD2
imu_gyro_y_radps	KEYWORD2
imu_gyro_z_radps	KEYWORD2
imu_mag_x_ut	KEYWORD2
imu_mag_y_ut	KEYWORD2
imu_mag_z_ut	KEYWORD2
imu_die_temp_c	KEYWORD2
static_pres_pa	KEYWORD2
diff_pres_pa	KEYWORD2
static_pres_die_temp_c	KEYWORD2
diff_pres_die_temp_c	KEYWORD2
gnss_fix	KEYWORD2
gnss_num_sats	KEYWORD2
gnss_lat_rad	KEYWORD2
gnss_lon_rad	KEYWORD2
gnss_alt_msl_m	KEYWORD2
gnss_alt_wgs84_m	KEYWORD2
gnss_hdop	KEYWORD2
gnss_vdop	KEYWORD2
gnss_track_rad	KEYWORD2
gnss_spd_mps	KEYWORD2
gnss_horz_acc_m	KEYWORD2
gnss_vert_acc_m	KEYWORD2
gnss_vel_acc_mps	KEYWORD2
gnss_track_acc_rad	KEYWORD2
nav_lat_rad	KEYWORD2
nav_lon_rad	KEYWORD2
nav_alt_msl_m	KEYWORD2
nav_alt_agl_m	KEYWORD2
nav_north_pos_m	KEYWORD2
nav_east_pos_m	KEYWORD2
nav_down_pos_m	KEYWORD2
nav_north_vel_mps	KEYWORD2
nav_east_vel_mps	KEYWORD2
nav_down_vel_mps	KEYWORD2
nav_gnd_spd_mps	KEYWORD2
nav_ias_mps	KEYWORD2
nav_pitch_rad	KEYWORD2
nav_roll_rad	KEYWORD2
nav_hdg_rad	KEYWORD2
nav_gyro_x_radps	KEYWORD2
nav_gyro_y_radps	KEYWORD2
nav_gyro_z_radps	KEYWORD2
effector	KEYWORD2
inceptor	KEYWORD2
throttle_ch	KEYWORD2
throttle_prcnt	KEYWORD2
params_size	KEYWORD2
params	KEYWORD2
param	KEYWORD2
updated_param	KEYWORD2
param_id	KEYWORD2
mission_updated	KEYWORD2
active_mission_item	KEYWORD2
num_mission_items	KEYWORD2
AdvanceMissionItem	KEYWORD2
fence_updated	KEYWORD2
num_fence_items	KEYWORD2
rally_points_updated	KEYWORD2
num_rally_points	KEYWORD2
SendStatusText	KEYWORD2
AircraftType	KEYWORD1
FIXED_WING	LITERAL1
HELICOPTER	LITERAL1
MULTIROTOR	LITERAL1
VTOL	LITERAL1
AircraftState	KEYWORD1
INIT	LITERAL1
STANDBY	LITERAL1
ACTIVE	LITERAL1
CAUTION	LITERAL1
EMERGENCY	LITERAL1
FTS	LITERAL1
AircraftMode	KEYWORD1
MANUAL	LITERAL1
STABALIZED	LITERAL1
ATTITUDE	LITERAL1
AUTO	LITERAL1
TEST	LITERAL1
GnssFix	KEYWORD1
GNSS_FIX_NONE	LITERAL1
GNSS_FIX_2D	LITERAL1
GNSS_FIX_3D	LITERAL1
GNSS_FIX_DGNSS	LITERAL1
GNSS_FIX_RTK_FLOAT	LITERAL1
GNSS_FIX_RTK_FIXED	LITERAL1
MissionItem	KEYWORD1
autocontinue	KEYWORD2
frame	KEYWORD2
cmd	KEYWORD2
param1	KEYWORD2
param2	KEYWORD2
param3	KEYWORD2
param4	KEYWORD2
x	KEYWORD2
y	KEYWORD2
z	KEYWORD2
gcs_lost_link_timeout_ms	KEYWORD2
gcs_link_established	KEYWORD2
gcs_link_lost	KEYWORD2
utm_update_period_s	KEYWORD2
utm_unix_time_us	KEYWORD2
utm_uas_id	KEYWORD2
utm_lat_rad	KEYWORD2
utm_lon_rad	KEYWORD2
utm_alt_wgs84_m	KEYWORD2
utm_rel_alt_m	KEYWORD2
utm_north_vel_mps	KEYWORD2
utm_east_vel_mps	KEYWORD2
utm_down_vel_mps	KEYWORD2
utm_horz_acc_m	KEYWORD2
utm_vert_acc_m	KEYWORD2
utm_vel_acc_mps	KEYWORD2
utm_next_lat_rad	KEYWORD2
utm_next_lon_rad	KEYWORD2
utm_next_alt_wgs84_m	KEYWORD2
utm_flight_state	KEYWORD2
utm_num_rx	KEYWORD2
UtmClearRx	KEYWORD2
FlightState	KEYWORD1
FLIGHT_STATE_UNKNOWN	LITERAL1
FLIGHT_STATE_GROUND	LITERAL1
FLIGHT_STATE_AIRBORNE	LITERAL1
FLIGHT_STATE_EMERGENCY	LITERAL1
FLIGHT_STATE_NOCTRL	LITERAL1
wind_north_vel_mps	KEYWORD2
wind_east_vel_mps	KEYWORD2
wind_down_vel_mps	KEYWORD2
wind_var_horz_mps	KEYWORD2
wind_var_vert_mps	KEYWORD2
wind_meas_alt_m	KEYWORD2
wind_horz_acc_mps	KEYWORD2
wind_vert_acc_mps	KEYWORD2
unix_time_us	KEYWORD2